^.####
#*...#
#.##.#
#.##.#
#....#
######